########################
#......................#
#......................#
#......................#
#......................#
#......................#
######UUUU######UUUU####
#......................#
#......................#
#.........P............#
#......................#
#......................#
#######DDDD######DDDD###
#......................#
#......................#
#......................#
#......................#
########################
